hindi_000.wav	अब रामपुर में अखिलेश बांटेंगे लैपटॉप का 'लॉलीपॉप'
hindi_001.wav	Flipkart: बंपर ऑफर्स के साथ बिक रहा है Lenovo का ये शानदार स्मार्टफोन
hindi_002.wav	मैं मुसीबत में पड़ गया।
hindi_003.wav	सुशील मोदी है 'अफवाह मियां', बिगड़ चुका है मानसिक संतुलन: तेजस्वी यादव
hindi_004.wav	प. बंगाल में मुस्लिम आरक्षण को भाजपा देगी चुनौती
hindi_005.wav	पाकिस्तानी कलाकार भले अच्छे हों, लेकिन देश पहले है: हेमा मालिनी
hindi_006.wav	नाइजीरिया स्कूल हमला: पीएम नरेंद्र मोदी ने की घटना की निंदा
hindi_007.wav	मैं तुम्हें तुम्हारे होमवर्क के साथ मदद करना चाहता हूँ।
hindi_008.wav	मुझे लगता है कि आपको कॉलेज जाना चाहिये।
hindi_009.wav	विपक्षी दलों ने मनाया काला दिवस
hindi_010.wav	वह मेरी चूत है।
hindi_011.wav	Box office का नया हीरो बना हॉरर, 'लैला मजनू', 'पलटन' पीछे
hindi_012.wav	मैं उठना चाहती हूँ।
hindi_013.wav	लाल बहादुर शास्त्री की डेथ मिस्ट्री पर फिल्म, इस रोल में दिखेंगे नसीरुद्दीन शाह
hindi_014.wav	...तो लंदन में एक ही दिन दो मैदानों पर भिड़ेंगे भारत और पाकिस्तान
hindi_015.wav	Opinion: विराट कोहली के लिए बेहतरीन मौका
hindi_016.wav	जयललिता बायोपिक से कंगना का लुक आउट, सोशल मीडिया पर हो गईं ट्रोल
hindi_017.wav	प्रेग्नेंट करीना की तबीयत बिगड़ी, घबराए सैफ ने रात में बुलाया नर्स को
hindi_018.wav	तुम्हारे बहुत सारे दुशमन हैं।
hindi_019.wav	ब्रेस्ट कैंसर की जागरूकता के लिए है पिंक रिबन ब्रा...
hindi_020.wav	यूपी: योगी सरकार के खिलाफ बीजेपी विधायकों का धरना खत्म, लेकिन दी ये चेतावनी
hindi_021.wav	तोहफे के रूप में लोगों की पहली पंसद है चॉकलेट
hindi_022.wav	मारुति का अब डीजल कारों पर रहेगा जोर
hindi_023.wav	एवेंजर्स एंडगेम Review: हर कसौटी पर खरी उतरती है सुपरहीरोज की फिल्म
hindi_024.wav	बिना सोचे कुछ मत कहना।
hindi_025.wav	उपहार कांड: इंसाफ से इनकार
hindi_026.wav	दिल्ली के उपराज्यपाल ने पुलिस प्रमुख को हटाने की मांग खारिज की
hindi_027.wav	वे एक-साथ खेल रहे हैं।
hindi_028.wav	क्या मैं अभी तुम्हारे लिए कुछ कर सकती हूं?
hindi_029.wav	मोरारी बापू ने भी माना, मोदी सरकार का ग्राफ नीचे आया
hindi_030.wav	इस सिम से मिलेगी दुनियाभर में अनलिमिटेड WhatsApp की आजादी
hindi_031.wav	नक़्शा कहाँ है?
hindi_032.wav	सरकार को खतरा नहीं: पी. चिदंबरम
hindi_033.wav	शादी से पहले नर्वस हैं शिल्पा
hindi_034.wav	सावन का तीसरा सोमवार और शिव जी के तीन स्वरूप
hindi_035.wav	छत्तीसगढ़ः परिवारवाद के मुद्दे पर कांग्रेस के अंदर ही मचा घमासान
hindi_036.wav	फैक्ट चेक: क्या उर्मिला मातोंडकर ने पीएम मोदी को कहा मानसिक रूप से बीमार?
hindi_037.wav	विक्की कौशल नहीं, राकेश शर्मा की बायोपिक में दिखेंगे रणबीर कपूर!
hindi_038.wav	गाजियाबाद: लड़की की मिली लाश, रेप की आशंका
hindi_039.wav	चेन्नईः महिलाओं की सुरक्षा को लेकर रेलवे का ढ़ीला रवैया
hindi_040.wav	मॉनसून ने दी कई स्थानों पर दस्तक
hindi_041.wav	गुड़गांवः ट्रैफिक लाइट ने बचाई सॉफ्टवेयर इंजीनियर की आबरू
hindi_042.wav	राहुल गांधी ने पूरा किया अमेठी के किसानों से किया वादा, भेजा खास गिफ्ट
hindi_043.wav	मैं पहुँचते ही तुम्हें फ़ोन करूँगी।
hindi_044.wav	पत्र किसको लिखा गया था?
hindi_045.wav	मैं भारत से हुँ
hindi_046.wav	संजू का नया पोस्टर रिलीज, मान्यता दत्त के किरदार में नजर आईं दिया मिर्जा
hindi_047.wav	राष्ट्रपति चुनाव के उम्मीदवार को लेकर असमंजस में है विपक्ष
hindi_048.wav	उसके हात-पैर लंबे हैं।
hindi_049.wav	भाभी ने झूठ बोला तो पत्नी पर पेट्रोल डाल कर लगा दी आग
