hindi_000.wav	ab raamapur mem akhilesh baamttemge laipattop kaa 'loliipop'
hindi_001.wav	Flipkart: bampar opharsa ke saath bik rahaa hai Lenovo kaa ye shaanadaar smaarttaphon
hindi_002.wav	maim musiibat mem padd gayaa.
hindi_003.wav	sushiil modii hai 'aphavaah miyaam', bigadd cukaa hai maanasik samtulan: tejasvii yaadav
hindi_004.wav	pa. bamgaal mem muslim aarakssann ko bhaajapaa degii cunautii
hindi_005.wav	paakistaanii kalaakaar bhale acche hom, lekin desh pahale hai: hemaa maalinii
hindi_006.wav	naaijiiriyaa skuul hamalaa: piiem naremdra modii ne kii ghattanaa kii nimdaa
hindi_007.wav	maim tumhem tumhaare homavarka ke saath madad karanaa caahataa huum.
hindi_008.wav	mujhe lagataa hai ki aapako kolej jaanaa caahiye.
hindi_009.wav	vipakssii dalom ne manaayaa kaalaa divas
hindi_010.wav	vah merii cuut hai.
hindi_011.wav	Box office kaa nayaa hiiro banaa horar, 'lailaa majanuu', 'palattan' piiche
hindi_012.wav	maim utthanaa caahatii huum.
hindi_013.wav	laal bahaadur shaastrii kii ddeth misttrii par philma, is rol mem dikhemge nasiiruddiin shaah
hindi_014.wav	...to lamdan mem ek hii din do maidaanom par bhiddemge bhaarat aur paakistaan
hindi_015.wav	Opinion: viraatt kohalii ke lie behatariin maukaa
hindi_016.wav	jayalalitaa baayopik se kamganaa kaa luk aautt, soshal miiddiyaa par ho gaiim ttrol
hindi_017.wav	pregnemtt kariinaa kii tabiiyat bigaddii, ghabaraae saiph ne raat mem bulaayaa narsa ko
hindi_018.wav	tumhaare bahut saare dushaman haim.
hindi_019.wav	brestta kaimsar kii jaagaruukataa ke lie hai pimk riban braa...
hindi_020.wav	yuupii: yogii sarakaar ke khilaaph biijepii vidhaayakom kaa dharanaa khatma, lekin dii ye cetaavanii
hindi_021.wav	tohaphe ke ruup mem logom kii pahalii pamsad hai cokalett
hindi_022.wav	maaruti kaa ab ddiijal kaarom par rahegaa jor
hindi_023.wav	evemjarsa emddagem Review: har kasauttii par kharii utaratii hai suparahiiroj kii philma
hindi_024.wav	binaa soce kuch mat kahanaa.
hindi_025.wav	upahaar kaamdd: imsaaph se inakaar
hindi_026.wav	dillii ke uparaajyapaal ne pulis pramukh ko hattaane kii maamg khaarij kii
hindi_027.wav	ve ek-saath khel rahe haim.
hindi_028.wav	kyaa maim abhii tumhaare lie kuch kar sakatii huum?
hindi_029.wav	moraarii baapuu ne bhii maanaa, modii sarakaar kaa graaph niice aayaa
hindi_030.wav	is sim se milegii duniyaabhar mem analimittedd WhatsApp kii aajaadii
hindi_031.wav	naqshaa kahaam hai?
hindi_032.wav	sarakaar ko khataraa nahiim: pii. cidambaram
hindi_033.wav	shaadii se pahale narvas haim shilpaa
hindi_034.wav	saavan kaa tiisaraa somavaar aur shiv jii ke tiin svaruup
hindi_035.wav	chattiisagaddhah parivaaravaad ke mudde par kaamgres ke amdar hii macaa ghamaasaan
hindi_036.wav	phaiktta cek: kyaa urmilaa maatomddakar ne piiem modii ko kahaa maanasik ruup se biimaar?
hindi_037.wav	vikkii kaushal nahiim, raakesh sharmaa kii baayopik mem dikhemge rannabiir kapuur!
hindi_038.wav	gaajiyaabaad: laddakii kii milii laash, rep kii aashamkaa
hindi_039.wav	cennaiih mahilaaom kii surakssaa ko lekar relave kaa ddhiilaa ravaiyaa
hindi_040.wav	monasuun ne dii kaii sthaanom par dastak
hindi_041.wav	guddagaamvah ttraiphik laaitt ne bacaaii sophttaveyar imjiiniyar kii aabaruu
hindi_042.wav	raahul gaamdhii ne puuraa kiyaa ametthii ke kisaanom se kiyaa vaadaa, bhejaa khaas giphtta
hindi_043.wav	maim pahumcate hii tumhem fon karuumgii.
hindi_044.wav	patra kisako likhaa gayaa thaa?
hindi_045.wav	maim bhaarat se hum
hindi_046.wav	samjuu kaa nayaa posttar riliij, maanyataa datta ke kiradaar mem najar aaiim diyaa mirjaa
hindi_047.wav	raassttrapati cunaav ke ummiidavaar ko lekar asamamjas mem hai vipakssa
hindi_048.wav	usake haat-pair lambe haim.
hindi_049.wav	bhaabhii ne jhuutth bolaa to patnii par pettrol ddaal kar lagaa dii aag
